
Name         : cqr
Address      : qwrv
Email I'd    : q wc
Phone Number : rvq
LInkedin I'd : ec

=========================================================================


Career Objective         : cq
Position Spught          : e


Educational Qualifications : 

Name of the Exam         : vew
Year of passing          : e
Institution              : cq
% of marks/grades        : ve


Professional experience : 

Name of the comp         : q
Job Responsibility       : wc
Projects Undertaken      : ev
Internship/Training      : qw
Online Training/Courses  : eq
Language Known           : vwe
Co-Curricular Activities : cw
Hobbies                  : v
Special Achievements     : eqcv


Personal Details : 

Mother or Father Name    : eevq
Date Of Birth            : we
Nationality              : vqw
Address                  : qwrv
References               : vqvew


I do hereby confirm that the information provided is true.
 cqr
 